107
Адаптив: адаптивный дизайн, адаптация интерфейса к использованию на разных экранах.
Аджайл: от англ. Agile. Общий термин, который описывает ценности и принципы гибкой разработки программного обеспечения, а также практические подходы к разработке. Понятие Agile стало популярным после публикации Манифеста гибкой разработки программного обеспечения в 2001 году.
Айдишник:  id, идентификатор.
Альфа: этап разработки программного обеспечения, на котором разработчики добавляют в программу новые функции, а тестировщики испытывают программу. Это внутренний или непубличный этап.
Апишка: API, программный интерфейс приложения или интерфейс прикладного программирования.
Апрув, апрувнуть: от англ. Approve. Одобрение, одобрить, утвердить.
Аутсорс: аутсорсинг, передача компанией части операционной деятельности другой компании.
Баг: от англ. Bug — жучок, клоп. Ошибка в программе.
Бахнуть: что-то быстро сделать, изменить или дополнить функциональность приложения.
Бета: бета-версия, приложение на стадии публичного тестирования.
Бот: сокращение от «робот». Ботом называют программу, которая автоматизирует интерфейс. Пример — автоответчик в чате.
Бэкап, бэкапить: резервная копия или процесс создания резервной копии приложения.
Бэкенд: от англ. Back-end. Программно-аппаратная или серверная часть приложения.
Бэклог: от англ. Backlog. Перечень рабочих задач команды разработчиков, упорядоченный по приотритету.
Ворнинг: от англ. Warning — предупреждение. Предупреждающее сообщение в интерфейсе.
Войтивайти: шуточное выражение, обозначает процесс переквалификации далекого от IT-сферы специалиста в разработчика.
Выкатить: сделать доступным для пользователей. Например, «выкатили новую версию сайта» значит сделали новую версию сайта доступной для пользователей.
Выпадашка: выпадающее меню, то же, что и «дропдаун».
Галера: компания, в которой платят низкие зарплаты и не ценят разработчиков.
Гит: система контроля версий Git или сервис GitHub.
Говнокод: плохой, некачественный код.
Градиент: плавный переход из одного цвета в другой.
Грумить: от англ. Grooming. Приводить в порядок, «причесывать».
Движок: в веб-разработке так называют системы управления контентом.
Дебажить: устранять ошибки, баги.
Деплой, деплоить: развёртывание, публикация рабочей версии приложения. Пример: задеплоить сайт — перенести сайт с тестового на рабочий сервер, сделать его доступным для пользователей.
Джун, Джуниор: от англ. Junior. Младший разработчик. Специалист без опыта или с минимальным опытом работы.
Дезигнер: презрительно-снисходительное название дизайнера.
Докеризировать: завернуть приложение в докер (платформу для разработки, доставки и запуска контейнерных приложений).
Драй: от англ. DRY, don’t repeat yourself. Принцип программирования, предлагающий избегать повторений кода.
Дропдаун: выпадающее меню, то же, что и «выпадашка».
Дропнуть: от англ. Drop. Удалить, отключить, сбросить или обнулить что-либо.
Жаба: язык программирования Java.
Жабаскрипт: язык программирования JavaScript.
Залить: загрузить. Например, «залить файлы на сервер».
Запилить: сделать что-то, добавить какую-то функциональность.
Змея: язык программирования Python.
Исходник: файлы, в которых находится исходный код приложения, или сам исходный код.
Итерация: повторение. «Мы сделали несколько итераций» — мы повторили шаг несколько раз.
Колл: от англ. Call. Созвон, онлайн-конференция, онлайн-совещание.
Коммит, коммитить: от англ. To commit — совершать. В контексте работы над приложением — сохранять код в репозитории.
Конфа: конференция.
Копипаста: от англ. Copy-Paste. Скопированный откуда-то код.
Костыль: код, который нужен, чтобы исправить несовершенство ранее написанного кода.
Легаси: от англ. Legacy. Морально устаревший код, который не обновляется, но используется. Или код, который разработчик получил по наследству от предыдущих разработчиков.
Либа: от англ. Library — библиотека. Речь идет о библиотеках кода, например, React.
Линтер: общее нарицательное название программ, которые анализируют код и предупреждают разработчика об ошибках.
Лист: от англ. List — список.
Локалка: локальный. Например, локальный сервер или сеть.
Мидл: от англ. Middle — средний. Уровень разработчика, следующий за джуниором. Опыт и уровень знаний миддла позволяет ему самостоятельно решать серьезные задачи.
Мёржить: от англ. Merge, сливать. Речь идет об объединении или слиянии веток кода.
Меншить: от англ. Mention — упоминание. Упоминанать в чатах или соцсетях. «Менши меня, когда будет готово» значит «упомяни меня, когда будет готово».
Навбар: навигационный блок на сайте или в интерфейсе программы.
Накатить: внести изменения, задеплоить новую версию приложения. Противоположное термину «откатить».
Опенсорс: от англ. Open Source. Программное обеспечение с открытым исходным кодом.
Откатить: удалить изменения, вернуть предыдущую версию приложения. Противоположное термину «накатить».
Ось: операционная система.
Падаван: ироничное название стажера или джуниора.
Пилот: пробная (пилотная) версия продукта.
Питон: язык программирования Python.
Подвал: то же, что и «футер». Элемент структуры страницы, который находится в нижней части и содержит служебную информацию — контакты, ссылки на соцсети, публичная оферта и т. д.
Поплыла вёрстка: некорректное отображение страницы в браузере.
Продакшн или продакшен (продакшн-код): обозначение кода для рабочей версии приложения.
Пушить: использовать команду push, публиковать что-то.
Пэхапэ: язык программирования PHP, то же, что и «пыха».
Пыха: язык программирования PHP, то же, что и «пэхапэ».
Рекурсия: описание процесса с помощью самого процесса. Например, выражение «рекурсивный вызов функции» описывает ситуацию, в которой функция вызывает сама себя.
Релиз: программное обеспечение на стадии публичного использования. Стабильная версия программы, которая прошла тестирование.
Релокация: перевод сотрудника или бизнеса в другое место внутри страны или за границу.
Репа: репозиторий, хранилище данных. Например, код программы можно хранить в репозитории на GitHub.
Ридми: файл Readme, в котором содержится информация о программе.
Ругаться (напр. линтер ругается): сообщения об ошибках в коде, работе сервиса и так далее.
Сабж: от английского Subject — тема, предмет. «По сабжу» — по теме обсуждения.
Свичнуть: переключить. От английского switch.
Сетка: модульная сетка, используется для дизайна и верстки страниц.
Сеньор, синьор: от англ. Senior — старший разработчик.
Слетело: сломалось.
Снести: удалить.
Сорец (Сорцы): от англ. Source. Исходный код.
Стек: изначально абстрактный тип данных. В разговорной речи используется для обозначения списка технологий, которые использует разработчик или компания. Пример: «Наш стек — HTML/CSS, JavaScript, React».
Собес: собеседование.
Софт: от англ. Software — программное обеспечение.
Софт-скиллы: от англ. Soft skills — знания и качества специалиста, прямо не связанные с профессиональной деятельностью. Примеры: коммуникабельность, проактивность.
Спринт: короткий промежуток времени (до 4 недель), в течение которого scrum-команда выполняет определенный объем работы.
Таска: от англ. Task. Задание, задача.
Тачка: компьютер.
Темплейт: от английского Template — шаблон.
Тестировщик: специалист по тестированию программного обеспечения.
Тимлид: от английского Team Lead — руководитель команды. Координатор группы программистов.
Убить: удалить что-то. Например, «убить профиль» означает удалить профиль.
Фидбек: от англ. Feedback — обратная связь.
Фиксить, пофиксить: от англ. Fix. Чинить, починить, исправить.
Фича: функция, возможность. От англ. Feature.
Фреймворк: от англ. Framework — каркас. Инструмент разработки, набор типовых шаблонных решений, упрощающих работу программиста. Примеры: Laravel, Bootstrap.
Фронтенд: от англ. Front-end — клиентская часть приложения.
Хатэмээль, хатээмэль: HTML, язык гипертекстовой разметки.
Хардкодить: статически прописывать в коде данные, которые должны вычисляться динамически. Плохая практика, антипаттерн в программировании.
Хацкер, кулхацкер: ироничное название начинающего специалиста, который считает себя опытным программистом. От английского Hacker и Cool Hacker.
Хедер, хэдер: элемент структуры веб-страницы, находится в верхней части и содержит логотип, меню, служебную информацию.
Хотфикс: от англ. Hotfix. Срочное исправление критических ошибок, уязвимостей или недоработок в программе.
Цэмээс, цээмэс: от англ. CMS — Content Management System, система управления контентом.
Цээсэс: от англ. CSS — Cascading Style Sheets, каскадные таблицы стилей.
Чекать, чекнуть, прочекать: от англ. Check. Проверять, проверить.
Юзать: от английского To use — использовать.
Ява: язык программирования Java.
Яваскрипт: язык программирования JavaScript.
ЯП: язык программирования.
